############################
# ##       ####   ## ## # S#
#    #                 ## ##
# ##    # ## # #### # ##   #
#  ###  #  #    ##   # #  ##
# #  #  #  #  ## # # #   ###
#   # ###  #  ##  #     # ##
######        #      #  #  #
##    ### ##   #    ###    #
#E #       #  ##   ######  #
############################