#########################
#S    #   #   # # #     #
##### ### ### # # ##### #
#     #   # # #     #   #
##### ### # # ##### ### #
# # # # # # #     # #   #
# # # # # # ##### # ### #
#       # #       # #   #
####### # ####### # ### #
# #       # # # # # #   #
# ####### # # # # # ### #
#       # #   #     #   #
####### # ### ##### ### #
# # # # #   # #         #
# # # # ### # ######### #
# #         #     # #   #
# ######### ##### # ### #
# #     # # #     # #   #
# ##### # # ##### # ### #
# # # #     # # # # # # #
# # # ##### # # # # # # #
#   #     # #     # # # #
### ##### # ##### # # # #
#                      E#
#########################